000000000000000000000000000000000000000000000000000000000000
000000000000000000002111111111111111111000000000000000000000
000000000000000000020000000222220000000200000000000000000000
000111110000000000200000000022200000000020000000000111110000
000111100000000002000000000002000000000002000000000011110000
000111000000000010000000000000000000000000100000000001110000
000110000000000010000000000000000000000000100000000000110000
000100000000000010000000000000000000000000100000000000010000
000000000000000010000000000000000000000000100000000000000000
000000000000000010000000000000000000000000100000000000000000
000000000000000020000000000000000000000000200000000000000000
000000000000000020000000000000000000000000200000000000000000
000000000000000020000000000000000000000000200000000000000000
000000000000000020000000000000000000000000200000000000000000
000000000000000020000000000000000000000000200000000000000000
000000000000000020000000000000000000000000200000000000000000
000000000000000020000000000000000000000000200000000000000000
000000000000000020000000000000000000000000200000000000000000
000000000000000020000000000000000000000000200000000000000000
000000000000000010000000000000000000000000100000000000000000
000000000000000010000000000000000000000000100000000000000000
000000000000000010000000000000000000000000100000000000000000
000000000000000010000000000000000000000000100000000000000000
000000000000000010000000000000000000000000100000000000000000
000000000000000002000000000001000000000002000000000000000000
000000000000000000200000000011100000000020000000000000000000
000000000000000000020000000111110000000200000000000000000000
000000000000000000002111111111111111112000000000000000000000
000222222222222200000000000000000000000000022222222222222000
000222222222222000000000000000000000000000021111111111100000
000222222222220000000000000000000000000000002111111111100000
000222222222200000000000000000000000000000000211111111100000
000111111112000000000000000000000000000000000021111111100000
000111111120000000000000000000000000000000000002111111100000
000111111200000000000000000000000000000000000000211111100000
000111112000000000000000000000000000000000000000021111100000
000111120000000000000000000000000000000000000000002111100000
000000000000000000000000000000000000000000000000000000000000
000000000000000000000000000000000000000000000000000000000000
000000000000000000000000000000000000000000000000000000000000
000000000000000000000000000000000000000000000000000000000000
000000000000000000000000000000000000000000000000000000000000
000000000000000000000000000000000000000000000000000000000000
000000000000000000000000000000000000000000000000000000000000
000000000000000000000000000000000000000000000000000000000000