000000000000222111000000000000000000000000000000000000000000
000000000000222111000000000000000000000000000000000000000000
000000000000222111000000000000000000000000000000000000000000
222111000000000000000000000000000000000000000000000000000000
222111000000000000000000000000000000000000000000000000000000
222111000000000000000000000000000000000000000000000000000000
000000000000222222222222221000000000000000022222220000000000
000000000000222222222222221000111000111000222222220000000000
000000000000000000111000111000111000111000111000000000000000
000111000111000000111000111000111000111000111000222000000000
000111000111000000111000111000111000111000111000222000000000
000111000111000000111000111000111000111000111000000000000000
000000000222000000222222222200000111111111000000222000000000
000000000222000000222222222200000111111111000000222000000000
000000000222000000111111111000000111111111000000222000000000
000000000222000000000000000000000000000000000000222000000000
000000000222000000000000000000000000000000000000222000000000
000000000222000000000000000000000000000000000000222000000000
000000000222000000111111111000000111111111000000222000000000
000000000222000000111111111000000111111111000000222000000000
000000000222000000111111111000000111111111000000222000000000
000000000000000000000000000000000000000000000000222000000000
000000000000000000000000000000000000000000000000222000000000
000000000000000000000000000000222000000000000000022200000000
000111111111000000000000000000222000000000000000222000000000
000111111111000000000000000000000000000000000000222000000000
000111111111000000000000000000000000000000000000222000000000
000000000002220000001111111110000001111111110000002220000000
000000000222000000111111111000000111111111000000222000000000
000000000222000000111111111000000111111111000000222000000000
000000000222000022222222222222221111111111111111222222222222
000111000111000000111000111000111000111000111000222222222222
000111000111000000111000111000111000111000111000222000000000
000111000111000000000000000000000000000000000000222000000000
000111000111000000000000000000000000000000000000222000000000
000111000111000000000000000000000000000000000000222000000000
000000000222222222000222000002220000002220000002220000000000
000000000222222222000222000002220000002220000002220000000000
000000000222000000000222000002220000002220000002220000000000
000000000222222222000222000002220000002220000000000000000000
000000000222222222000222000002220000002220000000000000000000
000000000222000000000222000002220000002220000000000000000000
000111000222000000000222000002220000000000000000222000000000
000000000222000000000222222222220000001110000002220000000000
000000000222000000000222222222220000001110000000222000000000