000000000000000000000000222000000000000000000000000000000000
000000000000000000000000222000000000000000000000000000000000
000000000000000000000000222000000000000000000000000000000000
000111000111000111000111000111000111000111000111000111000111
000111000111000111000111000111000111000111000111000111000111
000111000111000111000111000111000111000111000111000111000111
000000222000222000222000222000222000222000222000222000222000
000000222000222000222000222000222000222000222000222000222000
000000222000222000222000222000222000222000222000222000222000
000111000111000111000111000111000111000111000111000111000111
000111000111000111000111000111000111000111000111000111000111
000111000111000111000111000111000111000111000111000111000111
000000222000222000222000222000222000222000222000222000222000
000000222000222000222000222000222000222000222000222000222000
000000222000222000222000222000222000222000222000222000222000
000111000111000111000111000111000111000111000111000111000111
000111000111000111000111000111000111000111000111000111000111
000111000111000111000111000111000111000111000111000111000111
000000222000222000222000222000222000222000222000222000222000
000000222000222000222000222000222000222000222000222000222000
000000222000222000222000222000222000222000222000222000222000
000111000111000111000111000111000111000111000111000111000111
000111000111000111000111000111000111000111000111000111000111
000111000111000111000111000111000111000111000111000111000111
000000222000222000222000222000222000222000222000222000222000
000000222000222000222000222000222000222000222000222000222000
000000222000222000222000222000222000222000222000222000222000
000111000111000111000111000111000111000111000111000111000111
000111000111000111000111000111000111000111000111000111000111
000111000111000111000111000111000111000111000111000111000111
000000222000222000222000222000222000222000222000222000222000
000000222000222000222000222000222000222000222000222000222000
000000222000222000222000222000222000222000222000222000222000
000111000111000111000111000111000111000111000111000111000111
000111000111000111000111000111000111000111000111000111000111
000111000111000111000111000111000111000111000111000111000111
000000222000222000222000222000222000222000222000222000222000
000000222000222000222000222000222000222000222000222000222000
000000222000222000222000222000222000222000222000222000222000
000111000111000111000111000111000111000111000111000111000111
000111000111000111000111000111000111000111000111000111000111
000111000111000111000111000111000111000111000111000111000111
000000222000222000222000222000222000222000222000222000222000
000000222000222000222000222000222000222000222000222000222000
000000222000222000222000222000222000222000222000222000222000