000000000000111222000000000000000000000000000000000000000000
000000000000111222000000000000000000000000000000000000000000
000000000000111222000000000000000000000000000000000000000000
111222000000000000000000000000000000000000000000000000000000
111222000000000000000000000000000000000000000000000000000000
111222000000000000000000000000000000000000000000000000000000
000000000000222000222000222000222000222000222000111000000000
000000000000222000222000222000222000222000222000111000000000
000000000000222000222000222000222000222000222000111000000000
000000000000222000222000222000222000222000222000111000000000
000000000000222000222000222000222000222000222000111000000000
000000000000222000222000222000222000222000222000111000000000
000222222222000000000000000000000000000000000000111000000000
000222222222000000000000000000000000000000000000111000000000
000222222222000000000000000000000000000000000000111000000000
000000000111000000222222222000000222222222000000111000000000
000000000111000000222222222000000222222222000000111000000000
000000000111000000222222222000000222222222000000111000000000
000000000111000000000000000000000000000000000000111000000000
000000000111000000000000000000000000000000000000111000000000
000000000111000000000000000000000000000000000000111000000000
000000000111000000222222222000000222222222000000111000000000
000000000111000000222222222000000222222222000000111000000000
000000000111000000222222222000000222222222000000111000000000
000000000000000000000000000000000000000000000000111000000000
000000000000000000000000000000000000000000000000111000000000
000000000000000000000000000000000000000000000000111000000000
000222222222000000000000000000000000000000000000111000000000
000222222222000000000000000000000000000000000000111000000000
000222222222000000000000000000000000000000000000111000000000
000000000000000000222000222000222000222000222000000000000000
000000000000000000222000222000222000222000222000000000000000
000000000000000000222000222000222000222000222000000000000000
000222000222000000222000222000222000222000222000111000000000
000222000222000000222000222000222000222000222000111000000000
000222000222000000222000222000222000222000222000111000000000
000222000222000000000000000000000000000000000000111000000000
000222000222000000000000000000000000000000000000111000000000
000222000222000000000000000000000000000000000000111000000000
000000000111000000000000111000111000000111000000111000000000
000000000111000000000000111000111000000111000000111000000000
000000000111000000000000111000111000000111000000111000000000
000000000000000000000000000000000000000000000000000000000000
000000000000000000000000000000000000000000000000000000000000
000000000000000000000000000000000000000000000000000000000000