000000000000000000000000000111111000000000000000000000000000
000000000000000000000000000111111000000000000000000000000000
000000000000000000000000000111111000000000000000000000000000
000111111111000111111111000111111000111111111000111111111000
000111111111000111111111000111111000111111111000111111111000
000111111111000111111111000111111000111111111000111111111000
000111000000000000000111000111111000111000000000000000111000
000111000000000000000111000111111000111000000000000000111000
000111000000000000000111000111111000111000000000000000111000
000000000000111000000000000222222000000000000111000000000000
000000000000111000000000000222222000000000000111000000000000
000000000000111000000000000222222000000000000111000000000000
000111000000000000000111000111111000111000000000000000111000
000111000000000000000111000111111000111000000000000000111000
000111000000000000000111000111111000111000000000000000111000
000111111111000111111111000111111000111111111000111111111000
000111111111000111111111000111111000111111111000111111111000
000111111111000111111111000111111000111111111000111111111000
000000000000000000000000000111111000000000000000000000000000
000000000000000000000000000111111000000000000000000000000000
000000000000000000000000000222222000000000000000000000000000
111111111111222111111111112222222211111111111222111111111111
111111111111222111111111112222222211111111111222111111111111
111111111111222111111111112222222211111111111222111111111111
000000000000000000000000000222222000000000000000000000000000
000000000000000000000000000111111000000000000000000000000000
000000000000000000000000000111111000000000000000000000000000
000111111111000111111111000111111000111111111000111111111000
000111111111000111111111000111111000111111111000111111111000
000111111111000111111111000111111000111111111000111111111000
000111000000000000000111000111111000111000000000000000111000
000111000000000000000111000111111000111000000000000000111000
000111000000000000000111000111111000111000000000000000111000
000000000000111000000000000222222000000000000111000000000000
000000000000111000000000000222222000000000000111000000000000
000000000000111000000000000222222000000000000111000000000000
000111000000000000000111000111111000111000000000000000111000
000111000000000000000111000111111000111000000000000000111000
000111000000000000000111000111111000111000000000000000111000
000111111111000111111111000111111000111111111000111111111000
000111111111000111111111000111111000111111111000111111111000
000111111111000111111111000111111000111111111000111111111000
000000000000000000000000000111111000000000000000000000000000
000000000000000000000000000111111000000000000000000000000000
000000000000000000000000000111111000000000000000000000000000